|,-,-,-,-,-,-,-,-,|
|, , , , , , , ,!,|
|, ,|,-,-, ,|, , ,|
|,-,|, , , ,|, , ,|
|, , , ,!, ,|,-,-,|
|, , , , , ,|, , ,|
|, ,-,-,-, ,|, , ,|
|, ,|, , , ,|, , ,|
|, ,|, , , ,|, , ,|
|, ,|, ,|,-,|, , ,|
|,!, , ,|,E, ,!, ,|
|, , , ,|,-,-,-, ,|
|, , , , , , , , ,|
|,-,-,-,-,-,-,-,-,|