|,-,-,-,-,-,-,-,-,|
|, , , , ,!, , ,!,|
|, ,|,-,-,-,|, , ,|
|, ,|, , , ,|, , ,|
|, , , ,!, ,|,-,-,|
|, , , , , , , ,E,|
|,-,-,-,-,-,-,-,-,|