|,-,-,-,-,-,-,-,-,-,-,-,|
|, ,|,!, , , , , , ,!, ,|
|, ,|, , , , ,|,-,-, , ,|
|, ,|, , ,|, ,|, ,|, , ,|
|, ,|,!, ,|, ,|,E,|, , ,|
|, ,|, , ,|, ,|, ,|, , ,|
|, ,|,-,-,|, ,|, ,|, , ,|
|, , , , , , ,|,!,|, , ,|
|, , ,!, , , ,|, , , , ,|
|,-,-,-,-,-,-,-,-,-,-,-,|